border_size=1
usage=map

Gg          , Gg          , Gs^Fms      , Gg          , Gg          , Gg          , Gg          , Ww          , Ww          , Gg          , Gg          , Gg          , Gg          , Gg          , Gs^Fms      , Gg          , Gg          , Gg          , Rp          , Gg          , Gg          , Gg          , Gs^Fms      , Gg          , Gs^Fms      , Gs^Fms      , Gs^Fms      , Gs^Fms      , Gs^Fms      , Gg          , Gg          , Gg          , Gg          , Gg          , Gs^Fms      , Gs^Fms      , Gs^Fms      , Gg          , Gs^Fms      , Gs^Fms      , Gs^Fms      , Gg          , Gs^Fms      
Gs^Fms      , Gs^Fms      , Gll^Fmf     , Gs^Fms      , Gs^Fms      , Gs^Fms      , Gs^Fms      , Gs^Fms      , Gs^Fms      , Ww          , Ww          , Gg          , Gg          , Gs^Fms      , Gs^Fms      , Gs^Fms      , Rp          , Rp          , Gs^Fms      , Gs^Fms      , Gs^Fms      , Gs^Fms      , Gs^Fms      , Gs^Fms      , Gs^Fms      , Gs^Fms      , Gs^Fms      , Ww          , Ww          , Gg          , Gg          , Gll         , Gg          , Gg          , Gg          , Gs^Fms      , Gll^Fmf     , Gll^Fmf     , Gll^Fmf     , Gg^Ve       , Gs^Fms      , Gs^Fms      , Rp          
Gs^Fms      , Gs^Fms      , Gll^Fmf     , Gll^Fmf     , Gs^Fms      , Gg          , Gg          , Gs^Fms      , Gg          , Gg          , Gll         , Ww          , Gg          , Gg          , Gg          , Rp          , Gg          , Gs^Fms      , Gs^Fms      , Gll^Fmf     , Gs^Fms      , Gs^Fms      , Gs^Fms      , Gg          , Gs^Fms      , Gll^Fmf     , Gll^Fmf     , Gs^Fms      , Gs^Fms      , Ww          , Ww          , Gg          , Ww          , Gg          , Gg          , Gg          , Gs^Fms      , Gll^Fmf     , Gs^Fms      , Gll^Fmf     , Rp          , Rp          , Gs^Fms      
Gs^Fms      , Gs^Fms      , Gg          , Gs^Fms      , Gg          , Gs^Fms      , Gs^Fms      , Gs^Fms      , Ww          , Gg          , Ww          , Ww          , Ww          , Gg          , Gg          , Gg          , Gg          , Gg          , Gs^Fms      , Gg          , Gs^Fms      , Gs^Fms      , Gs^Fms      , Gs^Fms      , Gs^Fms      , Gg^Ve       , Gll^Fmf     , Gs^Fms      , Gg          , Gs^Fms      , Gg          , Ww          , Gg          , Ww          , Ww          , Gg          , Gg          , Gs^Fms      , Rp          , Rp          , Gs^Fms      , Gs^Fms      , Gg          
Gg          , Gs^Fms      , Gg          , Gs^Fms      , Gg          , Gg          , Ww          , Ww          , Gg          , Ww          , Gs          , Gg          , Gg          , Ww          , Ww          , Gg          , Gs^Fms      , Gs^Fms      , Gs^Fms      , Gs^Fms      , Gs^Fms      , Gs^Fms      , Gs^Fms      , Gs^Fms      , Gs^Fms      , Gs^Fms      , Gs^Fms      , Gll^Fmf     , Gs^Fms      , Gs^Fms      , Gg          , Gg          , Gg          , Gg          , Gg          , Ww          , Ww          , Gg          , Gg          , Gs^Fms      , Hh^Fms      , Gs^Fms      , Hh^Fms      
Gg          , Gg          , Ww          , Ww          , Ww          , Ww          , Gg          , Gg          , Gg          , Gg          , Gs          , Gs          , Gll         , Gg          , Ww          , Gg          , Gg          , Gs^Fms      , Gs^Fms      , Gll^Fmf     , Gll^Fmf     , Gg          , Gs^Fms      , Gs^Fms      , Gs^Fms      , Gs^Fms      , Gg^Efm      , Gs^Fms      , Gg^Efm      , Gg          , Gg          , Gg          , Gs^Vh       , Gg          , Gg          , Gg          , Ww          , Gg          , Gg          , Gs^Fms      , Hh^Fms      , Hh^Fms      , Hhd^Fmf     
Ww          , Ww          , Gg          , Gg          , Gg          , Gg          , Gg          , Gg          , Gg          , Gg          , Gg          , Gg          , Gg          , Gg          , Gg          , Ww          , Ww          , Gg          , Gg          , Gs^Fms      , Gs^Fms      , Gs^Fms      , Gs^Fms      , Gs^Fms      , Gs^Fms      , Gs^Fms      , Gg          , Gg          , Gg          , Gg^Efm      , Gg^Efm      , Gg          , Gg          , Gg          , Gll         , Gg          , Gg          , Ww          , Gg          , Gg          , Hh^Fms      , Hhd^Fmf     , Hh^Fms      
Gg          , Gg          , Gll         , Gg          , Gg          , Gg          , Gg^Efm      , Gs^Vh       , Gg          , Gs          , Gg          , Gg          , Gg          , Gg          , Gd          , Gg          , Gg          , Ww          , Ww          , Gg          , Gg          , Gs^Fms      , Gg          , Gg          , Gg^Efm      , Gg^Efm      , Gg          , Gg          , Rp          , Gg          , Gg^Efm      , Rp          , Rp          , Rp          , Rp          , Gg          , Gg          , Ww          , Gg          , Hh^Fms      , Hh^Fms      , Hh^Fms      , Hh^Fms      
Gg          , Gll         , Gg          , Gg          , Gg^Efm      , Gg^Efm      , Gg          , Gg^Efm      , Gg          , Gs          , Gg          , Gg          , Gg          , Gd          , Gg          , Gg          , Gg          , Gg          , Gg          , Ww          , Ww          , Gg          , Gg          , Gg          , Gg          , Gg          , Rp          , Rp          , Gd          , Gg          , Gg^Efm      , Gg          , Gg^Efm      , Gg^Efm      , Gg          , Gg          , Ww          , Ww          , Gg          , Hh          , Hh^Fms      , Gs^Fms      , Hh          
Gg          , Gll         , Gg          , Gg          , Gg^Efm      , Gg          , Gg          , Gg          , Gg          , Gg          , Gg          , Gg          , Gg          , Gg          , Gg          , Gg          , Gg          , Gg          , Gd          , Gg          , Gg          , Ww          , Ww          , Gg          , Gg          , Rp          , Gs          , Gs          , Gg          , Gg          , Gg          , Gg^Efm      , Gg          , Gg          , Ww          , Ww          , Gg          , Gg          , Gg          , Hh          , Hh          , Hh          , Hh          
Gg          , Gg          , Gg          , Gg^Efm      , Gg          , Gg          , Gg          , Gg          , Gll         , Gg          , Gg          , Gg          , Ce          , Ce          , Ce          , Gg          , Gg          , Gg          , Gg          , Gd          , Gg          , Gg          , Ww          , Gg          , Gg          , Gs          , Gs^Vh       , Gs          , Gs          , Gg          , Gg          , Gg          , Ww          , Ww          , Gg          , Gg          , Gg          , Gg          , Gg          , Hh          , Hh          , Hh          , Hh          
Gg          , Gg          , Gg          , Gg^Efm      , Gg          , Gg          , Gg          , Gg          , Gg          , Gll         , Gg          , Gg          , Gg          , Gg          , Gg          , Gg          , Gll         , Gg          , Gg          , Gg          , Gg          , Gg          , Ww          , Gg          , Gg          , Gg          , Gg          , Gg          , Gg          , Gg          , Ww          , Ww          , Gg          , Gg          , Gs          , Gs          , Gg          , Gg          , Hh          , Hh          , Hh          , Hh          , Gg          
Gg          , Gg          , Gg          , Gg          , Gg          , Gg          , Gg          , Gg          , Ce          , Gg          , Gg          , Gg          , Gg          , Gg          , Gg          , Gg          , Gg          , Gg          , Ce          , Gg          , Gg          , Gg          , Rp          , Wwf         , Wwf         , Gg          , Gg          , Gs          , Wwf         , Wwf         , Gs          , Gg          , Gs          , Gs          , Gg          , Gg          , Hh          , Hh          , Gg          , Hh          , Hh          , Hh          , Gg          
Gg          , Gg          , Gs          , Gs^Vh       , Gg          , Gg          , Gg          , Ce          , Gg          , Gg          , Gg          , Gg          , Gg          , Gd^Vo       , Gg          , Gg          , Gg          , Gg          , Gg          , Ce          , Gg          , Rp          , Gg          , Gg          , Gg          , Wwf         , Wwf         , Wwf         , Wwf         , Gs          , Gs          , Gs          , Gs          , Gg          , Gg          , Hh          , Hh          , Gg          , Hh          , Hhd         , Gg          , Hh          , Gg          
Gg          , Gg          , Gg          , Gs          , Gs          , Gg          , Gg          , Ce          , Gg          , Gg          , Gll         , Gg          , Gg          , Gg          , Gg          , Gg          , Gg          , Gg          , Gg          , Ce          , Gg          , Gg          , Hh          , Gg          , Hh          , Gg          , Gg          , Wwf         , Wwf         , Wwf         , Gg          , Gg          , Gs          , Gs^Vh       , Gg          , Gg          , Hh          , Gg          , Hh          , Hh          , Hh          , Hh          , Gg          
Gg          , Gg          , Gg          , Gg          , Gs          , Gs          , Gg          , Gg          , Gg          , Gg          , Gg          , Gg          , Co          , Co          , Co          , Gg          , Gg          , Gg          , Gg          , Gg          , Gg          , Hh          , Gg          , Hh          , Hh          , Gg          , Gg          , Gg          , Gg          , Wwf         , Wwf         , Gg          , Gg          , Gs          , Gs          , Gg          , Gg          , Hh          , Hh          , Hh          , Hhd         , Hh          , Hh          
Gg          , Gll         , Gll         , Gg          , Gg          , Gg          , Gg          , Gg          , Gg          , Gd^Vo       , Gg          , Gg          , Co          , 2 Kud       , Co          , Gg          , Gg          , Gd^Vo       , Gg          , Gg          , Gg          , Gg          , Gg          , Hhd         , Gg          , Gg          , Gg          , Gg          , Gg          , Gg          , Gg          , Wwf         , Ww          , Gg          , Gg          , Gs          , Gg          , Gg          , Gg          , Hh          , Hh          , Hh          , Gg          
Gg          , Gll         , Gg^Efm      , Gg          , Gg          , Gd          , Gg          , Gg          , Gg          , Gg          , Gg          , Gg          , Gg          , Co          , Gg          , Gg          , Gg          , Gg          , Gg          , Gg          , Gg          , Gg          , Gg          , Hh          , Gg          , Gg          , Gg          , Gs^Vc       , Gg          , Gg          , Gg          , Gg          , Gg          , Ww          , Ww          , Gg          , Gg          , Gg          , Gg          , Gg          , Gg          , Hh          , Gg          
Gg          , Gg          , Gg          , Gg          , Gg          , Gg          , Gg          , Ce          , Gg          , Gg          , Gg          , Gg          , Gg          , Gg          , Gg          , Gg          , Gs          , Gg          , Gg          , Ce          , Gg          , Gg          , Hh          , Hh          , Gg          , Gg          , Hh          , Gg          , Hh          , Hh          , Hh          , Gg          , Gg          , Gg          , Gg          , Ww          , Ww          , Gd          , Gg          , Gg          , Gg          , Hh          , Gg          
Gg          , Gg          , Gg          , Gg^Efm      , Gg          , Gg          , Gg          , Ce          , Ce          , Gg          , Gg          , Gs          , Gg          , Gd^Vo       , Gg          , Gs          , Gs          , Gs          , Ce          , Ce          , Rp          , Hh          , Hh          , Gg          , Gg          , Hh          , Hh          , Hhd         , Gg          , Gg          , Gg          , Gg          , Gg          , Gg          , Gg          , Gg          , Gg          , Ww          , Ww          , Gg          , Gg          , Gg          , Gg          
Gg          , Gg          , Gg          , Gg^Efm      , Gg^Efm      , Gg^Efm      , Gg          , Gg          , Gg          , Gg          , Gg          , Gg          , Gg          , Gg          , Gg          , Gg          , Gg          , Gg          , Gg          , Gg          , Hh          , Rp          , Rp          , Gg          , Gg          , Hh          , Gg          , Gg          , Gg          , Gg          , Hh          , Hh          , Hhd         , Gg          , Hh          , Gg          , Gg          , Gg          , Gg          , Ww          , Wwf         , Gg          , Gg          
Gg          , Gll         , Gll         , Gs^Vc       , Gg          , Gg          , Gd          , Gg          , Gg          , Gg          , Gg          , Gg          , Ce          , Gg          , Ce          , Gg          , Gg          , Gg          , Gg          , Gg          , Hh          , Gg          , Rp          , Gg          , Gg          , Gg          , Gg          , Gg          , Hh          , Hh          , Hh          , Hh          , Hhd         , Hh          , Hh          , Hh          , Gg          , Gg          , Gg          , Wwf         , Wwf         , Gg          , Gg          
Ww          , Gg          , Gg          , Gg          , Gg          , Gg          , Gg          , Gd          , Gd          , Gg          , Gg          , Gg          , Gg          , Ce          , Gg          , Gg          , Gg          , Gg          , Hh          , Hh          , Gg          , Hh          , Gg          , Rp          , Rp          , Gg          , Hh          , Hh          , Hh          , Gg          , Hh          , Hh          , Gg          , Gg          , Gg          , Gg          , Gs          , Gd          , Gg          , Gg          , Ww          , Gg          , Gg          
Gg          , Ww          , Ww          , Ww          , Ww          , Gg          , Gg          , Gg          , Gd          , Gg          , Gg          , Gg          , Gg          , Gg          , Gg          , Gg          , Rp          , Rp          , Rp          , Rp          , Rp          , Gg          , Gg          , Gg          , Hh          , Rp          , Rp          , Hhd         , Gg          , Hh          , Gg          , Gg          , Gs          , Gs          , Gs          , Gs          , Gg          , Gd          , Gg          , Gg          , Ww          , Gg          , Gg          
Gg          , Gg          , Gg          , Gg          , Gg          , Ww          , Ww          , Gg          , Gg          , Gg          , Gg^Efm      , Gg^Efm      , Gg^Efm      , Gg          , Gs          , Gs          , Gg          , Hh          , Hh          , Gg          , Rp          , Gg          , Hh          , Hh          , Hh          , Hh          , Gg          , Gg          , Gg          , Gg          , Gg          , Gs          , Gg          , Gg          , Gg          , Gg          , Gg          , Gg          , Ww          , Ww          , Gg          , Gg          , Gg          
Gg          , Gg          , Gg^Efm      , Gg          , Gg          , Gg          , Ww          , Gg          , Gg          , Gg          , Gg          , Gg          , Gg^Efm      , Gg          , Gg          , Gg          , Gg          , Gg          , Hh          , Hh          , Hh          , Rp          , Rp          , Hhd         , Hh          , Gg          , Gg          , Gg^Vct      , Gg          , Gg          , Gg          , Gg          , Gg          , Gg          , Gg^Vct      , Gll         , Gll         , Gg          , Ww          , Gg          , Gg          , Gg          , Gg          
Gg          , Gg^Efm      , Gg^Efm      , Gg^Efm      , Gg^Efm      , Gg          , Gg          , Wwf         , Wwf         , Gg          , Gg          , Gg          , Gg          , Gg          , Gg          , Gg          , Hh^Vhh      , Hh          , Gg          , Gg          , Hh          , Hh          , Hh          , Rp          , Rp          , Gs          , Gg          , Gg          , Gg          , Gg          , Ce          , Gg          , Gg          , Gg          , Gg          , Gg          , Gg          , Gg          , Ww          , Gg          , Gg          , Gs          , Gg          
Gg          , Gg^Efm      , Gg          , Gg          , Gg          , Gg^Efm      , Gg          , Gg          , Gg          , Ww          , Gg          , Gg          , Gg          , Gg          , Hh          , Hh          , Gg          , Hh          , Hh          , Hh          , Hhd         , Hh          , Gg          , Gg          , Gg          , Rp          , Gg          , Gg          , Gg          , Ce          , 1 Ke        , Ce          , Gg          , Gg          , Gg          , Gg          , Ww          , Ww          , Gg          , Gg          , Gs          , Gs          , Gg          
Gg          , Gg^Efm      , Gg          , Gg          , Gs^Vh       , Gg^Efm      , Gg^Efm      , Gg          , Gg          , Ww          , Ww          , Gg          , Gg          , Gg          , Gg          , Hh          , Gg          , Gg          , Hh          , Hh          , Hhd         , Hh          , Gg          , Gg          , Gg          , Gg          , Gg^Vct      , Gg          , Gg          , Ce          , Ce          , Wwf         , Wwf         , Gg          , Ww          , Ww          , Gg          , Gd          , Gg          , Gs          , Gs^Vh       , Gs          , Gg          
Gg          , Gg          , Gg          , Gg          , Gg          , Gg          , Gg^Efm      , Gg          , Gll         , Gg          , Gg          , Ww          , Gg          , Gll         , Gg          , Hh          , Hh          , Hh          , Hh          , Gg          , Hh          , Hh          , Hh          , Gg          , Gg          , Gg          , Gg          , Gg          , Gs          , Gg          , Gs          , Gg          , Gs          , Wwf         , Wwf         , Gg          , Gd          , Gg          , Gg          , Gs          , Gs          , Gg          , Gg          
Gg          , Gll         , Gg          , Gg^Efm      , Gg          , Gg^Efm      , Gg          , Gg          , Gg          , Gll         , Gll         , Ww          , Ww          , Gll         , Gll         , Gg          , Hh          , Hhd         , Hh          , Hh          , Hh          , Gll         , Hh          , Gg          , Gg          , Gg          , Gs          , Gs          , Gg          , Gs          , Gg          , Gs          , Gg          , Gg          , Gg          , Ww          , Gg          , Gg          , Gg          , Gg          , Gs          , Gg          , Gg          
Gg          , Gg          , Gg          , Gg          , Gg          , Gg          , Gg          , Gg          , Gg          , Gg          , Gg          , Gg          , Ww          , Gg          , Gg          , Gg          , Hh          , Gg          , Gg          , Hh          , Gg          , Hh          , Hh          , Hh          , Gg          , Gg          , Gg          , Gg          , Gg          , Gg          , Gg          , Gg          , Gg          , Gll         , Gg          , Ww          , Gg          , Gg          , Gg          , Gg          , Gs          , Gg          , Gg          
