border_size=1
usage=map

Md          , Md          , Md          , Md          , Md          , Md          , Md          , Md          , Md          , Mm          , Md          , Hhd         , Hhd         , Hhd         , Hhd         , Gg          , Gg          , Gs          , Gs          , Gs          , Hhd         , Hhd         , Hh          , Gg          , Hhd         , Gg          , Gg          , Gg          , Hhd         , Gg          , Hhd         , Gg          , Hhd         , Gg          , Hhd         , Gg          , Hhd         , Gs          , Gs          , Gg          
Md          , Md          , Md          , Md          , Md          , Md          , Md          , Md          , Md          , Md          , Md          , Md          , Hhd         , Hhd         , Hhd         , Hhd         , Hh          , Hhd         , Hhd         , Hh          , Gs          , Hhd         , Hh          , Gg          , Hhd         , Hhd         , Gg          , Hhd         , Hhd         , Hh          , Hh          , Hh          , Hh          , Hhd         , Gs          , Hhd         , Hh          , Hhd         , Hhd         , Gs          
Md          , Md          , Md          , Md          , Hhd         , Hhd         , Md          , Md          , Md          , Md          , Md          , Hhd         , Gg          , Hhd         , Gs          , Hh          , Gg          , Gs          , Hhd^Vo      , Hh          , Hh          , Hhd         , Gd          , Hh          , Hh          , Hhd         , Gd          , Hhd         , Hhd         , Hh          , Gs          , Hhd         , Hhd         , Gg          , Hh          , Hh          , Gg          , Hhd         , Gd          , Gg          
Md          , Md          , Hhd         , Hhd         , Md          , Md          , Md          , Md          , Md          , Md          , Hhd         , Hhd         , Hhd         , Gs          , Hhd         , Hhd         , Hhd         , Hhd         , Gg          , Hh          , Hh          , Gd          , Hhd         , Hhd         , Hh          , Gg          , Gd          , Hhd         , Hhd         , Gs          , Hhd         , Gs          , Hh          , Hhd         , Hh          , Hhd^Vo      , Hhd         , Hhd         , Gs          , Gd          
Md          , Md          , Hhd         , Md          , Md          , Md          , Hhd         , Hhd         , Md          , Hhd         , Hhd^Vo      , Hhd         , Hhd         , Hhd         , Hhd         , Gs          , Hhd         , Hhd         , Hhd         , Hhd         , Hh          , Hhd         , Gg          , Gg          , Hh          , Hh          , Hhd         , Hhd         , Gs          , Hhd         , Hhd         , Hhd         , Hh          , Hh          , Hhd         , Hhd         , Gs          , Hhd         , Hhd         , Gd          
Md          , Md          , Hhd         , Hhd         , Hhd         , Hhd         , Hhd         , Md          , Hhd         , Gg          , Gg          , Hhd         , Hhd         , Gg          , Gg          , Hh          , Hhd         , Hhd         , Hhd         , Hh          , Hh          , Hhd         , Hhd         , Hhd         , Hhd         , Gg          , Hhd         , Gg          , Gg          , Gd          , Gd          , Hhd         , Hhd         , Hh          , Hhd         , Gs          , Hhd         , Hhd         , Hhd         , Gs          
Md          , Md          , Hhd         , Hhd         , Hhd^Vo      , Hhd         , Hhd         , Hhd         , Re          , Gd          , Gd          , Gg          , Hhd         , Hhd         , Hhd         , Hh          , Hh          , Gg          , Hhd         , Hh          , Hh          , Hhd         , Gd          , Gd          , Gd          , Hhd^Vct     , Gg          , Gs          , Gg^Vct      , Gg          , Gd          , Gs          , Gs          , Hh          , Hh          , Hhd         , Hhd         , Hhd         , Gg          , Hhd         
Md          , Md          , Md          , Hhd         , Hhd         , Hhd         , Re          , Re          , Ww          , Re          , Re          , Gg          , Hhd         , Hhd         , Gs          , Hh          , Hh          , Hhd         , Gs          , Hhd         , Gg          , Gd          , Gg^Vct      , Gd          , Gg          , Gg          , Hhd         , Gg          , Gg          , Gg          , Gg          , Gd          , Gd          , Hhd         , Gs          , Hh          , Hhd         , Hhd         , Gs          , Hhd         
Md          , Md          , Hhd         , Hhd         , Hhd         , Hhd         , Re          , Ww          , Re          , Ww          , Ww          , Re          , Re          , Gs          , Gs          , Gs          , Hhd         , Hhd         , Hhd         , Hhd         , Hh          , Gg          , Gg          , Gg          , Hhd         , Hhd         , Ce          , Ce          , Ce          , Gg          , Gg          , Hhd         , Gd          , Hhd         , Hhd         , Hhd         , Hh          , Hhd         , Hhd         , Gs          
Hhd         , Hhd         , Re          , Hhd         , Re          , Re          , Re          , Ww          , Re          , Re          , Re          , Ww          , Ww          , Re          , Re          , Hhd         , Hhd         , Hhd         , Hhd         , Hh          , Hh          , Hh          , Hhd         , Hhd         , Hhd         , Ce          , Ww          , 1 Ke        , Ce          , Gg          , Gg^Vct      , Hhd         , Gd          , Hhd         , Hhd         , Gg          , Hh          , Hhd         , Hhd         , Gs          
Ww          , Hhd         , Ww          , Re          , Ww          , Ww          , Ww          , Ww          , Re          , Re          , Gg          , Re          , Re          , Ww          , Ww          , Re          , Re          , Hh          , Hhd         , Hh          , Hh          , Hh          , Hhd         , Re          , Ww          , Ww          , Ce          , Ce          , Ce          , Gg          , Gg          , Hhd         , Gg          , Hhd         , Gg          , Hhd         , Hh          , Hhd         , Gg          , Gs          
Re          , Ww          , Re          , Ww          , Re          , Re          , Re          , Re          , Gg          , Re          , Gs          , Gd          , Gd          , Re          , Re          , Ww          , Ww          , Re          , Re          , Hhd         , Hhd         , Hh          , Hhd         , Re          , Ww          , Re          , Gg          , Ce          , Gg          , Gg          , Gg          , Hhd         , Hh          , Hh          , Hh          , Hhd         , Hh          , Hhd         , Hhd         , Gs          
Hhd         , Re          , Hhd         , Re          , Hhd         , Re          , Ce          , Ce          , Gg          , Gs          , Gg          , Gg          , Hhd         , Gd          , Gd          , Re          , Re          , Ww          , Ww          , Re          , Re          , Hhd         , Hhd         , Re          , Ww          , Re          , Gg          , Gg          , Gg          , Gg          , Hhd         , Hhd         , Hhd         , Hh          , Hh          , Hh          , Hh          , Hhd         , Gg          , Hhd         
Hhd         , Hhd         , Hhd^Vo      , Hhd         , Hhd         , Ce          , Ce          , Gg          , Gs          , Gs          , Hhd         , Hhd         , Hhd         , Hhd         , Hhd         , Gd          , Gg          , Re          , Re          , Ww          , Ww          , Re          , Re          , Re          , Ww          , Re          , Hhd         , Hhd         , Hhd         , Hh          , Hh          , Hh          , Gd          , Gd          , Hhd         , Hh          , Hhd         , Hh          , Hhd         , Hhd         
Hhd         , Hhd         , Hhd         , Hhd         , Hhd         , Ce          , 2 Ke        , Ce          , Gg          , Gs          , Hhd         , Gg          , Hhd         , Gg          , Gd          , Gd          , Hhd         , Hhd         , Re          , Re          , Re          , Ww          , Ww          , Re          , Ww          , Re          , Hhd         , Gg          , Hh          , Hh          , Hh          , Hh          , Hh          , Hhd         , Hhd         , Hhd         , Hhd^Vo      , Hh          , Gg          , Gg          
Hhd         , Hhd         , Hhd^Fmf     , Hhd         , Hhd         , Ce          , Ce          , Ce          , Gg          , Hhd^Vo      , Hhd         , Hhd         , Hhd         , Hhd         , Gg          , Hhd         , Hhd         , Hhd         , Hhd         , Re          , Re          , Re          , Re          , Ww          , Ww          , Re          , Hhd         , Hh          , Hh          , Hh          , Hh          , Hh          , Hh          , Hh          , Hh          , Hhd         , Hh          , Hh          , Hhd         , Gg          
Hhd         , Hhd         , Hhd^Fmf     , Hhd^Fmf     , Hhd         , Ce          , Ce          , Gg          , Gg          , Hhd         , Hhd         , Gd          , Gg          , Hhd         , Hhd         , Hhd         , Hhd^Vo      , Hhd         , Hhd         , Hhd         , Hhd         , Hhd         , Re          , Rb          , Ww          , Re          , Hhd^Vo      , Hhd         , Hhd         , Gg          , Hhd         , Hhd         , Hhd         , Hhd         , Hhd         , Hh          , Hhd         , Hh          , Hh          , Hhd         
Hhd         , Hhd         , Hhd^Fmf     , Hhd         , Hhd^Vo      , Hhd         , Hhd         , Ce          , Gg          , Hhd         , Hhd         , Gg          , Hhd         , Hhd         , Gg          , Gd          , Hhd         , Hhd         , Gd          , Hhd         , Gg          , Hhd         , Hhd         , Re          , Ww          , Re          , Gg          , Hhd         , Gg          , Hhd         , Gg          , Hhd         , Gg          , Gg          , Gg          , Hhd         , Gg          , Gg          , Gs          , Gg          
Hhd^Fmf     , Hhd^Fmf     , Hhd^Fmf     , Hhd^Fmf     , Hhd^Fmf     , Hhd         , Hhd         , Hhd         , Hhd         , Hhd         , Gs          , Gs          , Gg          , Hhd         , Hhd         , Hhd         , Hhd         , Gd          , Hhd         , Hhd         , Gg          , Hhd         , Re          , Re          , Ww          , Gg          , Gs          , Gg          , Gs          , Gs          , Gs          , Gs          , Gs          , Gs          , Gg          , Gg          , Gg          , Gs          , Gg          , Gg          
Hhd^Fmf     , Hhd^Fmf     , Hhd^Fmf     , Hhd^Fmf     , Hhd^Fmf     , Hhd         , Hhd^Fmf     , Hhd         , Hhd         , Hhd         , Hhd         , Gs          , Hhd         , Hhd         , Gg          , Hhd         , Gg          , Hhd         , Hhd         , Hhd         , Hhd         , Hhd         , Gg          , Re          , Wot         , Gs          , Gs          , Gs          , Gg          , Gg          , Gll         , Gll         , Gs^Fms      , Gll         , Gs^Fms      , Gg          , Gs^Fms      , Gll         , Gll         , Gg          
Hhd^Fmf     , Hhd^Fmf     , Hhd^Fmf     , Hhd^Fmf     , Hhd^Fmf     , Hhd^Fmf     , Hhd^Fmf     , Hhd^Fmf     , Hhd^Fmf     , Hhd^Fmf     , Hhd^Fmf     , Hhd^Fmf     , Gll^Fmf     , Hhd         , Hhd         , Hhd         , Hhd         , Hhd         , Hhd         , Hhd         , Gg          , Gg          , Gg          , Re          , Wot         , Gg          , Gg          , Gg          , Gll^Fmf     , Gll^Fmf     , Gs^Fms      , Gll         , Gll^Fmf     , Gll^Fmf     , Gll^Fmf     , Gll^Fmf     , Gll^Fmf     , Gs^Fms      , Gs^Fms      , Gg          
Hhd^Fmf     , Hhd^Fmf     , Gs^Fms      , Gs^Fms      , Gs^Fms      , Gll^Fmf     , Gll^Fmf     , Gll^Fmf     , Hhd^Fmf     , Hhd^Fmf     , Gll^Fmf     , Gll^Fmf     , Gll^Fmf     , Gll^Fmf     , Hhd         , Gg          , Hhd         , Gg          , Hhd         , Gg          , Gg          , Gg          , Gg          , Gd          , Wot         , Gll         , Gll         , Gll^Fmf     , Gs^Fms      , Gs^Fms      , Gs^Fms      , Gll^Fmf     , Gll^Fmf     , Gll^Fmf     , Gll^Fmf     , Gs^Fms      , Gs^Fms      , Gll^Fmf     , Gll^Fmf     , Gs^Fms      
Hhd^Fmf     , Hhd^Fmf     , Gs^Fms      , Gs^Fms      , Gs^Fms      , Gs^Fms      , Gs^Fms      , Gs^Fms      , Gs^Fms      , Gs^Fms      , Gs^Fms      , Gs^Fms      , Gs^Fms      , Gll^Fmf     , Hhd^Fmf     , Hhd         , Gs^Fms      , Hhd         , Gg          , Gg          , Gg          , Gg          , Wot         , Wot         , Gs^Fms      , Gs^Fms      , Gs^Fms      , Gs^Fms      , Gs^Fms      , Gs^Fms      , Gs^Fms      , Gs^Fms      , Gs^Fms      , Gs^Fms      , Gs^Fms      , Gs^Fms      , Gs^Fms      , Gs^Fms      , Gs^Fms      , Gs^Fms      
Gs^Fms      , Gs^Fms      , Gs^Fms      , Gs^Fms      , Gs^Fms      , Gs^Fms      , Gs^Fms      , Gs^Fms      , Gs^Fms      , Gs^Fms      , Gs^Fms      , Gs^Fms      , Gs^Fms      , Gs^Fms      , Gs^Fms      , Gs^Fms      , Gs^Fms      , Gs^Fms      , Gs^Fms      , Gs^Fms      , Ww          , Wot         , Gs^Fms      , Gs^Fms      , Gs^Fms      , Gs^Fms      , Gs^Fms      , Gs^Fms      , Gs^Fms      , Gs^Fms      , Gs^Fms      , Gs^Fms      , Gs^Fms      , Gs^Fms      , Gs^Fms      , Gs^Fms      , Gs^Fms      , Gs^Fms      , Gs^Fms      , Gs^Fms      
Gs^Fms      , Gs^Fms      , Gs^Fms      , Gs^Fms      , Gs^Fms      , Gs^Fms      , Gs^Fms      , Gs^Fms      , Gs^Fms      , Gs^Fms      , Gs^Fms      , Gs^Fms      , Gs^Fms      , Gs^Fms      , Gs^Fms      , Gs^Fms      , Gs^Fms      , Gs^Fms      , Wwf         , Wwf         , Gs^Fms      , Gs^Fms      , Gs^Fms      , Gs^Fms      , Gs^Fms      , Gs^Fms      , Gs^Fms      , Gs^Fms      , Gs^Fms      , Gs^Fms      , Gs^Fms      , Gs^Fms      , Gs^Fms      , Gs^Fms      , Gs^Fms      , Gs^Fms      , Gs^Fms      , Gs^Fms      , Gs^Fms      , Gs^Fms      
Gs^Fms      , Gs^Fms      , Gs^Fms      , Gg^Ve       , Gs^Fms      , Gs^Fms      , Gs^Fms      , Gs^Fms      , Gs^Fms      , Gs^Fms      , Gs^Fms      , Gs^Fms      , Gs^Fms      , Gs^Fms      , Gs^Fms      , Gs^Fms      , Wot         , Ww          , Gs^Fms      , Gs^Fms      , Gs^Fms      , Gs^Fms      , Gs^Fms      , Gs^Fms      , Gs^Fms      , Gg^Ve       , Gs^Fms      , Gs^Fms      , Gs^Fms      , Gg^Ve       , Gs^Fms      , Gs^Fms      , Gs^Fms      , Gs^Fms      , Gs^Fms      , Gs^Fms      , Gs^Fms      , Gs^Fms      , Gs^Fms      , Gs^Fms      
Gs^Fms      , Gs^Fms      , Gs^Fms      , Gs^Fms      , Gs^Fms      , Gs^Fms      , Gs^Fms      , Gs^Fms      , Gg^Ve       , Gs^Fms      , Gs^Fms      , Gs^Fms      , Gs^Fms      , Gs^Fms      , Wot         , Wot         , Gs^Fms      , Gs^Fms      , Gs^Fms      , Gs^Fms      , Gs^Fms      , Gs^Fms      , Gs^Fms      , Cv          , Cv          , Gs^Fms      , Cv          , Cv          , Cv          , Gs^Fms      , Cv          , Cv          , Gs^Fms      , Gs^Fms      , Gs^Fms      , Gg^Ve       , Gs^Fms      , Gs^Fms      , Gs^Fms      , Gs^Fms      
Gs^Fms      , Gs^Fms      , Gs^Fms      , Gs^Fms      , Gs^Fms      , Gs^Fms      , Gs^Fms      , Gs^Fms      , Gs^Fms      , Gs^Fms      , Gs^Fms      , Gs^Fms      , Wot         , Wot         , Gs^Fms      , Gs^Fms      , Gs^Fms      , Gs^Fms      , Gs^Fms      , Gg^Ve       , Gs^Fms      , Gs^Fms      , Gs^Fms      , Gs^Fms      , Gs^Fms      , Cv          , Gg^Ve       , 3 Kv        , Gg^Ve       , Cv          , Gs^Fms      , Gs^Fms      , Gs^Fms      , Gs^Fms      , Gs^Fms      , Gs^Fms      , Gs^Fms      , Gs^Fms      , Gs^Fms      , Gs^Fms      
Gs^Fms      , Gs^Fms      , Gs^Fms      , Gs^Fms      , Gs^Fms      , Gs^Fms      , Gs^Fms      , Gs^Fms      , Gs^Fms      , Gs^Fms      , Wot         , Wot         , Gs^Fms      , Gs^Fms      , Gs^Fms      , Gs^Fms      , Gs^Fms      , Gs^Fms      , Gs^Fms      , Gs^Fms      , Gs^Fms      , Gs^Fms      , Gs^Fms      , Gs^Fms      , Gs^Fms      , Gs^Fms      , Gs^Fms      , Gs^Fms      , Gs^Fms      , Gs^Fms      , Gs^Fms      , Gs^Fms      , Gs^Fms      , Gs^Fms      , Gs^Fms      , Gs^Fms      , Gs^Fms      , Gs^Fms      , Gs^Fms      , Gs^Fms      
