border_size=1
usage=map

Ms^Xm       , Ms^Xm       , Ms^Xm       , Ms^Xm       , Ms^Xm       , Ms^Xm       , Ms^Xm       , Ms^Xm       , Ms^Xm       , Ms^Xm       , Ms          , Ms          , Ms          , Ms          , Ms          , Ms          , Ms          , Ha          , Ha          , Ha          , Hhd         , Ha          , Ha          , Gd          , Ai          , Ai          , Gd          , Ms          , Ms          , Ms          , Ms          , Ms          , Ms          , Ms          , Ms^Xm       , Ms^Xm       , Ms^Xm       , Ms^Xm       , Ms^Xm       
Ms^Xm       , Ms^Xm       , Ms^Xm       , Ms^Xm       , Ms^Xm       , Ms^Xm       , Ms^Xm       , Ms^Xm       , Ms          , Ms          , Ms          , Ms          , Ms          , Ms          , Md          , Md          , Ha          , Ha^Fma      , Ha          , Hhd         , Hhd         , Ha          , Ha          , Gd          , Gd          , Ai          , Ai          , Hhd         , Ha^Fma      , Ms          , Md          , Ms          , Ms          , Ms          , Ms^Xm       , Ms^Xm       , Ms^Xm       , Ms^Xm       , Ms^Xm       
Ms^Xm       , Ms^Xm       , Ms          , Ms^Xm       , Ms^Xm       , Ms          , Ms          , Ms          , Ms          , Ms          , Ms          , Ms          , Ms          , Ms          , Aa          , Aa          , Ha          , Ha^Fma      , Ha          , Hhd         , Hhd         , Ha          , Ha          , Gd          , Gd          , Gd          , Ai          , Wwg         , Gd          , Ha^Fma      , Hhd         , Md          , Md          , Ms          , Ms          , Ms^Xm       , Ms^Xm       , Ms^Xm       , Ms^Xm       
Ms^Xm       , Ms^Xm       , Ms^Xm       , Ms^Xm       , Ms          , Ms          , Ms          , Ms          , Ms          , Ms          , Ms          , Ms          , Aa          , Aa          , Gd          , Gd          , Ha          , Aa^Vca      , Ha          , Ha          , Ha          , Gd          , Ha          , Ha          , Gd          , Gd          , Wwg         , Ai          , Gd          , Hhd         , Ha^Vhha     , Hhd         , Ms          , Ms          , Ms          , Ms          , Ms          , Ms^Xm       , Ms^Xm       
Ms^Xm       , Ms^Xm       , Ms          , Ms          , Ms          , Ms          , Ms          , Ms          , Ms          , Md          , Md          , Aa          , Cea         , Cea         , Cea         , Gd          , Gd          , Ha          , Ha          , Ha          , Ha          , Ha          , Hhd         , Ha          , Gd          , Gd          , Gd          , Ai          , Ai          , Ha          , Ha          , Ha^Fma      , Ha^Fma      , Ms          , Ms          , Ms          , Ms          , Ms          , Ms^Xm       
Ms^Xm       , Ms^Xm       , Ms          , Ms          , Ms          , Ms          , Ha^Fma      , Md          , Md          , Ms          , Aa^Vca      , Aa          , Cea         , 1 Kea       , Cea         , Gd          , Gd          , Gd          , Ha          , Ha          , Gd          , Ha          , Ha          , Ha          , Gd          , Gd          , Gd          , Wwg         , Ai          , Gd          , Gd          , Ha^Fma      , Ha^Fma      , Ms          , Ms          , Ms          , Ms          , Ms          , Ms^Xm       
Ms          , Ms^Xm       , Mm          , Md          , Ha          , Ms          , Ha^Fma      , Ha^Fma      , Aa          , Aa          , Ha          , Gd          , Gd          , Cea         , Aa          , Gd          , Gd          , Ha          , Ha          , Gd          , Hhd         , Ha          , Ha          , Gd          , Gd          , Gd          , Gd          , Gd          , Wwg         , Ai          , Gd          , Gd          , Ha^Fma      , Ha^Fma      , Hhd         , Md          , Md          , Ms          , Ms          
Ms          , Ms          , Ha          , Ha          , Gd          , Ha^Fma      , Ha^Fma      , Ha^Fma      , Ha          , Ha          , Ha          , Gd          , Aa          , Aa          , Aa          , Aa          , Ha          , Ha          , Gd          , Hhd         , Aa          , Hhd         , Gd          , Gd          , Aa          , Aa          , Gd          , Gd          , Gd          , Ai          , Ai          , Gd          , Gd          , Aa^Fma      , Hhd         , Hhd         , Md          , Ms          , Ms          
Ha          , Ha          , Ha          , Ha          , Ha          , Ha^Fma      , Ha^Fma      , Ha          , Ha          , Gd          , Ha          , Gd          , Aa          , Aa          , Ha          , Ha          , Gd          , Aa^Vla      , Aa          , Aa          , Aa^Fma      , Aa          , Gd          , Aa          , Aa          , Aa          , Aa          , Gd          , Gd          , Ai          , Ai          , Ai          , Gd          , Gd          , Hhd         , Hhd         , Hhd         , Ms          , Ms          
Ha          , Ha          , Hhd         , Ha          , Hhd         , Ha          , Ha          , Hhd         , Ha          , Ha          , Ha          , Ha          , Aa          , Ha          , Gd          , Ha          , Gd          , Aa          , Aa          , Aa^Fma      , Aa^Fma      , Aa          , Gd          , Gd          , Aa^Fma      , Aa^Fma      , Gd          , Aa          , Gd          , Gd          , Ai          , Ai          , Ai          , Gd          , Gd          , Hhd         , Hhd         , Hhd         , Hhd         
Ha          , Ha          , Hhd         , Hhd         , Hhd         , Ha          , Ha          , Hhd         , Hhd         , Ha          , Ha          , Ha          , Aa          , Gd          , Gd          , Gd          , Gd          , Aa          , Aa          , Aa^Fma      , Aa^Fma      , Aa          , Gd          , Gd          , Gd          , Aa^Fma      , Gd          , Gd          , Gd          , Gd          , Ai          , Wwg         , Ai          , Ai          , Wwg         , Gd          , Gd          , Hhd         , Hhd         
Ha          , Ha          , Ha^Vhha     , Hhd         , Aa          , Ha          , Ha          , Aa          , Ha          , Hhd         , Ha          , Ha          , Aa          , Aa          , Aa          , Aa          , Aa          , Aa          , Aa          , Aa^Fma      , Gd          , Gd          , Aa          , Gd          , Aa          , Gd          , Aa          , Gd          , Gd          , Gd          , Gd          , Ai          , Gd          , Ai          , Ai          , Ai          , Gd          , Gd          , Gd          
Ha          , Ha          , Ha          , Gd          , Ha          , Ha          , Ha          , Ha          , Gd          , Ha          , Gd          , Gd          , Gd          , Aa          , Aa          , Aa          , Aa          , Aa          , Gd          , Gd          , Gd          , Gd          , Aa          , Aa          , Gd          , Aa          , Aa          , Aa          , Gd          , Gd          , Gd          , Gd          , Gd^Vhr      , Gd          , Gd          , Ai          , Ai          , Gd          , Gd          
Gd          , Ha          , Ha          , Ha          , Gd          , Gd          , Gd          , Gd          , Gd          , Gd          , Gd          , Gd          , Gd          , Aa          , Aa          , Aa          , Gd          , Aa          , Gd          , Gd          , Gd          , Aa          , Aa          , Gd^Vhr      , Gd          , Gd          , Gd          , Gd          , Gd          , Gd          , Gd^Vct      , Gd          , Gd          , Gd          , Gd          , Aa          , Gd          , Ai          , Ai          
Ha          , Ha          , Gd          , Gd          , Aa          , Aa          , Aa          , Aa          , Aa          , Gd          , Gd^Vhr      , Gd          , Gd          , Gd          , Aa          , Gd          , Gd          , Gd          , Gd          , Gd          , Gd          , Gd          , Gd          , Aa          , Gd          , Gd          , Aa          , Gd          , Gd          , Cha         , Gd          , Gd          , Gd          , Gd          , Aa          , Gd          , Gd          , Ai          , Ai          
Gd          , Gd          , Gd          , Gd          , Aa          , Aa          , Gd          , Gd          , Rb          , Gd          , Gd          , Gd          , Rb          , Aa          , Aa          , Aa          , Aa          , Gd          , Gd          , Gd          , Gd          , Gd          , Gd          , Gd          , Gd          , Aa          , Gd          , Aa          , Rb          , Gd          , Cha         , Cha         , Cha         , Gd          , Re          , Aa          , Aa          , Gd          , Gd          
Gd          , Gd          , Aa          , Gd          , Aa          , Gd          , Rb          , Rb          , Gd          , Rb          , Rb          , Rb          , Aa          , Aa          , Aa          , Aa^Vca      , Aa          , Gd          , Rb          , Gd          , Gd          , Gd          , Gd          , Gd          , Rb          , Gd          , Rb          , Rb          , Cha         , Rb          , Cha         , 2 Kha       , Cha         , Re          , Gd          , Re          , Re          , Aa          , Gd          
Gd          , Gd          , Aa          , Aa          , Rb          , Rb          , Gd          , Gd          , Gd          , Gd          , Gd          , Gd          , Aa^Fma      , Aa^Fma      , Aa          , Aa          , Gd          , Rb          , Gd          , Rb          , Rb          , Gd          , Rb          , Rb          , Gd          , Rb          , Gd          , Gd          , Gd          , Gd          , Gd          , Cha         , Gd          , Gd          , Gd^Vct      , Gd          , Gd          , Re          , Re          
Rb          , Gd          , Rb          , Rb          , Gd          , Gd          , Gd          , Gd          , Gd          , Gd          , Gd          , Gd          , Gd          , Aa^Fma      , Gd          , Aa          , Gd          , Gd          , Gd          , Gd          , Gd          , Rb          , Gd          , Gd          , Gd          , Gd          , Gd          , Gd          , Gd          , Gd^Vct      , Gd          , Gd          , Gd          , Gd          , Gd          , Aa          , Aa          , Gd          , Gd          
Gd          , Rb          , Gd          , Gd          , Gd          , Gd          , Gd          , Gd          , Aa          , Aa          , Aa          , Aa          , Gd          , Aa^Fma      , Aa          , Gd          , Gd          , Gd          , Gd          , Gd          , Gd          , Gd          , Gd          , Gd          , Aa          , Aa          , Aa          , Gd          , Gd          , Gd          , Gd          , Gd          , Aa^Fma      , Gd          , Aa          , Gd          , Aa          , Aa          , Gd          
Aa          , Gd          , Gd          , Gd          , Aa          , Gd          , Aa          , Aa          , Aa          , Aa          , Aa          , Aa          , Aa          , Aa^Fma      , Gd          , Aa          , Aa          , Gd          , Gd          , Gd          , Aa          , Gd          , Aa          , Aa          , Aa          , Aa          , Aa          , Gd          , Gd          , Gd          , Aa^Fma      , Aa^Fma      , Aa          , Aa          , Aa          , Aa          , Aa          , Aa          , Gd          
Aa          , Aa          , Aa          , Aa          , Aa^Fma      , Aa          , Aa          , Aa          , Aa^Vca      , Aa          , Aa          , Aa          , Aa          , Aa          , Aa          , Gd          , Aa          , Gd          , Aa          , Aa          , Aa          , Aa          , Aa          , Aa          , Aa          , Aa          , Aa          , Gd          , Aa          , Aa          , Aa          , Aa          , Aa          , Gd^Vhr      , Gd          , Aa          , Aa          , Gd          , Gd          
Aa          , Aa          , Aa          , Aa          , Aa^Fma      , Aa          , Aa          , Aa          , Aa          , Aa          , Aa          , Aa          , Aa          , Aa          , Aa          , Aa          , Aa^Fma      , Aa          , Aa^Fma      , Aa          , Aa          , Aa^Vca      , Aa          , Aa          , Aa          , Aa          , Gd          , Gd          , Gd          , Aa          , Aa          , Aa          , Gd          , Aa          , Gd          , Gd          , Aa          , Gd          , Gd          
Aa          , Aa          , Aa          , Aa          , Aa          , Aa^Fma      , Aa          , Aa          , Aa          , Aa          , Aa          , Aa          , Gd          , Aa          , Gd          , Aa          , Aa          , Aa^Fma      , Aa^Fma      , Aa^Fma      , Aa          , Aa          , Aa          , Aa          , Gd          , Gd          , Gd          , Gd          , Aa          , Aa          , Gd          , Aa          , Aa          , Aa          , Aa          , Gd          , Aa          , Gd          , Gd          
Aa          , Aa          , Aa          , Aa          , Aa          , Aa          , Aa          , Aa          , Aa          , Aa          , Gd          , Gd          , Gd          , Gd          , Gd          , Aa          , Aa          , Aa          , Gd          , Aa          , Aa          , Aa          , Gd          , Gd          , Aa          , Gd          , Aa          , Gd          , Aa          , Aa          , Gd          , Aa          , Aa          , Aa          , Aa          , Aa^Vca      , Aa          , Aa          , Gd          
Aa          , Aa          , Gd          , Gd          , Gd          , Aa          , Aa          , Aa          , Gd          , Gd          , Gd          , Gd          , Gd          , Gd          , Gd          , Gd          , Gd          , Gd          , Gd          , Gd          , Gd          , Gd          , Gd          , Gd          , Gd          , Aa          , Gd          , Aa          , Gd          , Gd          , Gd          , Gd          , Gd          , Gd          , Aa          , Aa          , Gd          , Gd          , Gd          
Gd          , Gd          , Gd          , Gd          , Gd          , Gd          , Gd          , Gd          , Gd          , Gd          , Gd          , Gd          , Gd          , Gd          , Gd          , Gd          , Gd          , Gd          , Gd          , Gd          , Gd          , Gd          , Gd          , Gd          , Gd          , Gd          , Gd          , Gd          , Gd          , Gd          , Gd          , Gd          , Gd          , Gd          , Gd          , Gd          , Gd          , Gd          , Gd          
