border_size=1
usage=map

Cha         , Cha         , Ms          , Mm          , Mm          , Ms          , Ms          , Ms          , Mm          , Ms          , Mm          , Ms          , Mm          , Ms          , Mm          , Ms          , Ms          , Ms          , Mm          , Ms          , Mm          , Mm          , Mm          , Mm          , Mm          , Ms          , Mm          , Mm          , Mm          , Ms          , Mm          , Ms          , Mm          , Ms          , Mm          , Ms          , Mm          , Ms          , Mm          , Ms          , Mm          , Ms          , Mm          , Ms          
Cha         , Cha         , Ms          , Mm          , Mm          , Mm          , Mm          , Mm          , Mm          , Mm          , Cea         , Cea         , Cea         , Mm          , Mm          , Mm          , Mm          , Mm          , Mm          , Mm          , Mm          , Mm          , Ms          , Mm          , Mm          , Mm          , Mm          , Mm          , Aa^Vha      , Mm          , Ms          , Mm          , Mm          , Mm          , Mm          , Mm          , Ms          , Mm          , Ms          , Mm          , Ha^Vhha     , Mm          , Rb          , Ms          
Cha         , Cha         , Ha          , Mm          , Ha          , Mm          , Hh          , Mm          , Ha          , Ha^Vhha     , Cea         , 1 Ke        , Cea         , Ms          , Ha          , Ms          , Ha^Vhha     , Mm          , Ha          , Ms          , Ha          , Ms          , Ha          , Ms          , Ha          , Ms          , Ha          , Ms          , Ha          , Ha          , Ha          , Ms          , Ha          , Ms          , Ha          , Ms          , Ha          , Hh          , Hh          , Hh          , Hh          , Rb          , Hh          , Hh          
Cha         , Cha         , Re          , Ha          , Ha          , Hh          , Ha          , Hh          , Re          , Hh          , Ha          , Cea         , Ha          , Ha          , Ha          , Ha          , Ha          , Ha          , Hh          , Ha          , Hh          , Hh          , Hh          , Hh          , Hh          , Hh          , Re          , Ha          , Re          , Ha          , Ha          , Ha          , Re          , Ha          , Re          , Ha          , Aa          , Re          , Re          , Re          , Re          , Re          , Ce          , Ce          
Cha         , Cha         , Re          , Re          , Re          , Re          , Aa          , Re          , Re          , Aa          , Re          , Re          , Aa          , Re          , Re          , Re          , Aa          , Re          , Aa          , Hh          , Re          , Re          , Re          , Re          , Re          , Re          , Re          , Re          , Aa          , Aa          , Aa          , Re          , Hh          , Re          , Hh          , Re          , Re          , Aa          , Re          , Re          , Re          , Ce          , 2 Ke        , Ce          
Cha         , Cha         , Aa^Vha      , Re          , Ha          , Re          , Hh          , Re          , Hh          , Re          , Aa^Vha      , Re          , Ha          , Re          , Ha          , Aa          , Re          , Aa          , Re          , Aa          , Re          , Aa          , Re          , Aa          , Re          , Re          , Re          , Re          , Ha          , Re          , Hh          , Hh          , Hh          , Hh          , Ha          , Hh          , Hh          , Aa          , Ha          , Aa          , Hh          , Ce          , Ce          , Ce          
Cha         , Cha         , Ms          , Ha          , Mm          , Hh          , Ms          , Hh          , Ms          , Ha          , Hh          , Hh          , Hh          , Hh          , Hh          , Hh          , Hh          , Hh          , Hh          , Ha          , Ha          , Ha          , Ha          , Ha          , Ha          , Ha          , Ha          , Ha          , Ha          , Hh          , Ms          , Hh          , Ms          , Ha          , Ms          , Ms          , Ms          , Ha          , Ms          , Ha          , Hh          , Ha^Vhha     , Ha          , Ce          
Cha         , Cha         , Ms          , Ms          , Mm          , Mm          , Mm          , Mm          , Mm          , Mm          , Mm          , Mm          , Mm          , Mm          , Mm          , Ms          , Mm          , Hh          , Mm          , Mm          , Mm          , Mm          , Mm          , Mm          , Mm          , Ms          , Ms          , Mm          , Mm          , Mm          , Mm          , Mm          , Mm          , Ms          , Ha^Vhha     , Ms          , Mm          , Mm          , Mm          , Rb          , Mm          , Hh          , Mm          , Ha          
Cha         , Cha         , Ms          , Ms          , Ms          , Ms          , Ms          , Mm          , Mm          , Mm          , Ms          , Ms          , Ms          , Mm          , Ms          , Mm          , Ms          , Mm          , Mm          , Ms          , Ms          , Ms          , Ms          , Ha^Vhha     , Ms          , Ms          , Ms          , Mm          , Ms          , Mm          , Ms          , Mm          , Ms          , Ms          , Ms          , Ms          , Ms          , Ms          , Ms          , Ms          , Ms          , Mm          , Ms          , Ms          
